##^#########
#   #      #
#   #  #   #
#   #  #   #
#      #   #
############/

