|########|
|        |
|        |
|        |
|        |
|########|
-
|########|
|###     |
| #      |
|      # |
|     ###|
|########|
-
|########|
|      # |
| #    # |
| #    # |
| #      |
|########|