####^######
#% %     ##
#%        #
#   *     #
#   #  XXX#
###########/

