#########
#........
#........
#........
#........
#########
-
#########
#........
#..#.....
#..#.....
#..#.....
#########
-
#########
#..####..
#...##...
#...#....
#........
#########
