##^#########
#          #
#          #
#       %%%#
#      %%%%#
############/

