####^###########
#%      %     ##
#%             #
#   *          #
#   #  XXX     #
#   #  XXXX    #
#   #         *#
################/

