#########|
#        |
#        |
#        |
#        |
#########|
-
#########|
#        |
#  #     |
#  #     |
#  #     |
#########|
-
#########|
#   ###  |
#   ##   |
#   #    |
#        |
#########|