#########
........#
........#
........#
........#
#########
-
#########
.....####
.......##
........#
......###
#########
-
#########
........#
.#.#.#..#
.#.#.#..#
........#
#########
