####^#########
#%      %   ##
#%           #
#   *        #
#   #  XX    #
#   #  XXX   #
#   #       *#
##############/

