|#########
|        #
|        #
|        #
|        #
|#########
-
|#########
|     ####
|       ##
|        #
|      ###
|#########
-
|#########
|        #
| # # #  #
| # # #  #
|        #
|#########