###########
# #      ##
#   ##    #
#   #     #
#   #     #
###########/

