#########
.........
.........
.........
.........
#########
-
#########
###......
.#.......
......#..
.....###.
#########
-
#########
......#..
.#....#..
.#....#..
.#.......
#########
